15
50
##################################################
E     ##     ####     ##     ####     ##         # 
###     ##     #######     ##     ###     ##     # 
##     ####     ##     ####     ##     ###       # 
####     ##     ####     ##     ####     ##      #
##     ####     ##     ####     ##     ###       #
###     ##     #######     ##     ###     ##     # 
    ##     ####     ##     ####     ##     ###   #   
####     ##     ####     ##     ####     ##      #
##     ####     ##     ####     ##     ###       #      
###     ##     #######     ##     ###     ##     # 
    ##     ####     ##     ####     ##      S    #
##     ####     ##     ####     ##     ###       #
    ####     ##     ####     ##     ####         #
##################################################
