10
30
##############################
E   ##       ##   ##   ##   # 
    #   ##   ##   ##   ##   ##
##    #     ##   #   ##   ##  
   ##    #         #        ##
   ####  ##   ##     #  ##   #
    #   ##   ##    #   ##   ##
##    ###  ##    #    #   ####
   ##   ##   ##   ##    #    S
############################## 