8
12
############
E         #S
##### ######
#          #
###### #####
#          #
###### #####
############