13
13
#############
E     #     #
##### # ### #
#   # # # # #
# # ### # # #
# #     # # #
# ####### # #
#         #S#
#############