9
9
#########
E     # #
# ### # #
# #   # #
# # ### #
#   #   #
### # ###
#     S #
#########