5
7
#######
#     #
# ### #
#   S #
#######